You wake up in a grassy field with no memory of what happened last night. You search your pockets and find that you only have a stick of gum, a rusty razor blade, and a bag of white powder. There is also a dog running around the farm that looks vaguely familiar. As you come to you glance at your watch you notice that it is Thursday at 800 a.m, ONE AND A HALF HOURS BEFORE YOUR BIG JOB INTERVIEW! You begin to panic but then realize that you are just a 25-minute drive outside of town, and can still make it. Now if you just had a car. . .

What happened last night?
An Interactive Fiction by Dakota Miller
Release 1 / Serial number 141002 / Inform 7 build 6L38 (I6/v6.33 lib 6/12N) SD

Field
A large grassy field with a large apple tree in the center of it and a large patch of tall grass next to you. You can just see the sun rising over the shed which is to the east.  To the north is the barn and to the south is a corn field.

>please
(There is no need to say please.)
I didn't understand that sentence.

* * *

>x watch
A small black wrist watch

The Dog runs away

>x apple tree
An apple that is at least 40 feet tall and is beginning to flower

>x tall grass
You rustle through the tall grass and find a small piece of crumpled paper

>take paper
Taken.

The dog is here

>read paper
The paper reads: For a good time call 1-800-696-9911

The Dog runs away

* * *

>get into car
you get into the car

>start car
That's not a verb I recognise.

* * *

>e
Shed
A medium sized metal shed made of couragated tin sheets. There are many different car parts scattered around the floor. In the corner there are pieces of an old wooden fence as well as some barbed wire. In the other corner is a workbench made of wood with may different things on it.  To the north a car port is attached to the shed behind a locked metal door. Back to the east is the field

>open tool chest
You open the tool chest revealing a hammer, screwdriver, wrench, and a small box.

>open small box
You open the small box, revealing a carkey.

>take car key
You can't see any such thing.

>take carkey
Taken.

>n
(first opening the metal door)
It seems to be locked.

The dog is here

>open metal door
It seems to be locked.

The Dog runs away

>unlock metal door
What do you want to unlock the metal door with?

* * *

>e
Shed
A medium sized metal shed made of couragated tin sheets. There are many different car parts scattered around the floor. In the corner there are pieces of an old wooden fence as well as some barbed wire. In the other corner is a workbench made of wood with may different things on it.  To the north a car port is attached to the shed behind a locked metal door. Back to the east is the field

>open tool box
I only understood you as far as wanting to open Tool chest.

>open tool chest
You open the tool chest revealing a hammer, screwdriver, wrench, and a small box.

>open small box
You can't see any such thing.

* * *

>x dog
A medium sized sheep dog with a light blue collar around its neck

The Dog runs away

>e
Shed
A medium sized metal shed made of couragated tin plates. There are many tools scattered around the shed as well as some old wooden fence posts and barbed wire. To the north a car port is attached to the shed behind a locked metal door. back th the east is the field

The dog is here

>w
Field
A large grassy field with a large apple tree in the center of it and a large patch of tall grass next to you. You can just see the sun rising over the shed which is to the east.  To the north is the barn and to the south is a corn field.

>n
Barn
A large red and white 2 story barn with piles of hay on the ground. There are also two black and white cows roaming around the barn. Hanging on the wall is a milking bucket and leaning on the wall next to it is a pitchfork. The barns looks if it hasnt been used in years. Back to the south is the field.

* * *

>start car
That's not a verb I recognise.

>start car
You then turn the screwdriver in the igntition, praying that it will work. After some clicking you hear the car engine roar to life and you breathe a sigh of releif knowing that you can finally get off of this farm. You will have to worry about your less than professional attire when you get to the interview.

>take kay
You can't see any such thing.

>take key
    *** The End ***

Would you like to RESTART, RESTORE a saved game, QUIT or UNDO the last command?

* * *

>start car
That's not a verb I recognise.

>take car
You can't see any such thing.

* * *

>0
That's not a verb I recognise.

>unlock car
You can't see any such thing.

I beg your pardon?

I beg your pardon?

>take dog
That's hardly portable.

The Dog runs away

>n
Barn
A large red and white two story barn with piles of hay on the ground. There are also two black and white cows roaming around the barn. Hanging on the wall is a milking bucket and leaning on the wall next to it is a pitchfork. The barns looks if it hasn't been used in years. Back to the south is the field.

>rules on
Rules tracing now switched on. Type "rules off" to switch it off again, or "rules all" to include even rules which do not apply.

>actions on
[Rule "declare everything initially unmentioned rule" applies.]
Actions listing on.

>n
[Rule "declare everything initially unmentioned rule" applies.]
[Rule "standard set going variables rule" applies.]
[going north]
[Rule "announce items from multiple object lists rule" applies.]
[Rule "set pronouns from items from multiple object lists rule" applies.]
[Rule "before stage rule" applies.]
[Rule "instead stage rule" applies.]
[Rule "investigate player's awareness before action rule" applies.]
[Rule "player aware of his own actions rule" applies.]
[Rule "check stage rule" applies.]
[Rule "can't travel in what's not a vehicle rule" applies.]
[Rule "can't go through undescribed doors rule" applies.]
[Rule "can't go through closed doors rule" applies.]
[Rule "determine map connection rule" applies.]
[Rule "can't go that way rule" applies.]
You can't go that way.
[going north - failed the can't go that way rule]

[Rule "A first turn sequence rule" applies.]
[Rule "every turn stage rule" applies.]
[Rule "Every turn" applies.]
[Rule "A last turn sequence rule" applies.]
[Rule "notify score changes rule" applies.]

>x tree
You can't see any such thing.

>x apple tree
You can't see any such thing.

* * *

>open car
You open Car.

The Dog runs away

>get into car
you breathe a sigh of releif

>start car
That's not a verb I recognise.

>drive to shed
That's not a verb I recognise.

>drive
That's not a verb I recognise.

>close door
You can't see any such thing.

>close car
You close Car.

It is now pitch dark in here!

>ride car
That's not a verb I recognise.

>e
Darkness
It is pitch dark, and you can't see a thing.

>open door
You can't see any such thing.

>open car
You open Car.

Shed (in Car)
A medium sized metal shed made of couragated tin plates. There are many tools scattered around the shed as well as some old wooden fence posts and barbed wire. To the north a car port is attached to the shed behind a locked metal door. back th the east is the field

* * *

>x paper
The paper reads: For a good time call 1-800-6969-911

The Dog runs away

>x piece of paper
You see nothing special about Piece of paper.

The dog is here

>x gum
You see nothing special about Stick of gum.

The Dog runs away

>x stick of gum
You see nothing special about Stick of gum.

>x pink speedo
You see nothing special about Pink speedo.

The dog is here

>x self
You are only wearing a sparkly pink speedo and a watch and are otherwise naked

The Dog runs away

* * *

>x paper
The paper reads: For a good time call 1-800-6969-911

The Dog runs away

>read paper
You must supply a noun.

* * *

>x gum
 A stick of juicy fruit gum

The Dog runs away

* * *

>take eky
You can't see any such thing.

>take key
Taken.

The Dog runs away

>e
Shed
A medium sized metal shed made of couragated tin plates. There are many tools scattered around the shed as well as some old wooden fence posts and barbed wire. To the north a car port is attached to the shed behind a locked metal door. back th the east is the field

>unlock metal door
What do you want to unlock metal door with?

>key
You unlock metal door.

>open metal door
You open metal door.

>n
You can't go that way.

>s
You can't go that way.

>e
You can't go that way.

>w
Field
A large grassy field with a large apple tree in the center of it and a large patch of tall grass next to you. You can just the sun rising over the shed which is to the east.  To the north is the barn, to the south is is a corn field, and to the west is a forest.

* * *

>take key
Taken.

The Dog runs away

>s
Cornfield
A corn field filled with small 1-foot tall stalks of corn sprouting out of the dark brown soil. In the center of the fields is a scare crow dressed in plaid shorts and shorts. Back to the north is the field

The dog is here

>x plaid shorts
A plaid shirt and shorts used to dress the scarecrow

The Dog runs away

>x dirt
Brown dirt that the corn is growing out of

>x soil
Brown dirt that the corn is growing out of

The dog is here

>x corn stalks
A green corn stalk that is just beginning to grow

The Dog runs away

>n
Field
A large grassy field with a large apple tree in the center of it and a large patch of tall grass next to you. You can just see the sun rising over the shed which is to the east.  To the north is the barn and to the south is a corn field.

The Dog runs away

>e
Shed
A medium sized metal shed made of corrugated tin sheets. There are many different car parts scattered around the floor. In the corner there are pieces of an old wooden fence as well as some barbed wire. In the other corner is a workbench made of wood with may different things on it.  To the north a car port is attached to the shed behind a locked metal door. Back to the east is the field

The Dog runs away

>x walls
The metal walls are coated in a thin layer of dust.

The dog is here

>x floor
A cement floor covered in an assortment of different small car parts. All covered in a thin layer of dirt.

The Dog runs away

>x work bench
A wooden work bench with a tool chest and a pile of cut wood on it.

>x workbench
A wooden work bench with a tool chest and a pile of cut wood on it.

* * *

>i
You are carrying:
  rusty razor blade
  stick of gum
  pink speedo
  bag of white powder
  watch

The Dog runs away

* * *

>take key
Taken.

The Dog runs away

>n
Barn
A large red and white two story barn with piles of hay on the ground. There are also two black and white cows roaming around the barn. Hanging on the wall is a milking bucket and leaning on the wall next to it is a pitchfork. The barns looks if it hasn't been used in years. Back to the south is the field.

>x cows
Two female black and white cows, each with a cow bell around its neck

>x milking bucket
A medium sized aluminum bucked used to collect milk from the cows

The dog is here

>x pitchfork
A pitchfork with a wooden handle and a metal head used to move hay around

The Dog runs away

>x ground
You can't see any such thing.

>s
Field
A large grassy field with a large apple tree in the center of it and a large patch of tall grass next to you. You can just see the sun rising over the shed which is to the east.  To the north is the barn and to the south is a corn field.

The Dog runs away

* * *

>take key
Taken.

The Dog runs away

>e
Shed
A medium sized metal shed made of corrugated tin sheets. There are many different car parts scattered around the floor. In the corner there are pieces of an old wooden fence as well as some barbed wire. In the other corner is a workbench made of wood with may different things on it.  To the north a car port is attached to the shed behind a locked metal door. Back to the east is the field

>open tool chest
You open the tool chest revealing a hammer, screwdriver, wrench, and a small box.

The dog is here

>open box
You open the small box, revealing a carkey.

The Dog runs away

>take car key
Taken.

The dog is here

>x key
A silver key that unlocks something

The Dog runs away

>x car key
A key that unlocks and starts a car

The dog is here

>unlock metal door
What do you want to unlock the metal door with?

>key
You unlock the metal door.

The Dog runs away

>open metal door
You open the metal door.

>n
Carport
In the middle of the room sits a dull red car. Everything in this room is covered in a thin layer of dust and dirt. Back to the south is the shed.

>x dog
You can't see any such thing.

>s
Shed
A medium sized metal shed made of corrugated tin sheets. There are many different car parts scattered around the floor. In the corner there are pieces of an old wooden fence as well as some barbed wire. In the other corner is a workbench made of wood with may different things on it.  To the north a car port is attached to the shed behind a locked metal door. Back to the east is the field

>take screwdriver
Taken.

The dog is here

>n
Carport
In the middle of the room sits a dull red car. Everything in this room is covered in a thin layer of dust and dirt. Back to the south is the shed.

>unlock red car
What do you want to unlock the car with?

>screw driver
You can't see any such thing.

>screwdriver
That's not a verb I recognise.

>unlock car
What do you want to unlock the car with?

>screwdriver
You unlock the car.

>x doors
You can't use multiple objects with that verb.

>x car door
A dull red door with a low quality silver lock that fits a flat key

>x tin sheets
You can't see any such thing.

>x corrugated tin sheets
You can't see any such thing.

>x walls
You can't see any such thing.

>s
Shed
A medium sized metal shed made of corrugated tin sheets. There are many different car parts scattered around the floor. In the corner there are pieces of an old wooden fence as well as some barbed wire. In the other corner is a workbench made of wood with may different things on it.  To the north a car port is attached to the shed behind a locked metal door. Back to the east is the field

The dog is here

>x walls
The metal walls are coated in a thin layer of dust.

The Dog runs away

>x workbench
A wooden work bench with a tool chest and a pile of cut wood on it.

>x tool chest
A rusty old tool chest

In Tool chest are Hammer, Wrench and a small box.

* * *

>score
There is no score in this story.

I beg your pardon?

>sadksad'a
That's not a verb I recognise.

I beg your pardon?

>sad
That's not a verb I recognise.

>d
You can't go that way.

The Dog runs away

>ad
That's not a verb I recognise.

>sd
That's not a verb I recognise.

>sas
That's not a verb I recognise.

I beg your pardon?

>ds
That's not a verb I recognise.

I beg your pardon?

>take key
You can't see any such thing.

>dog
That's not a verb I recognise.

* * *

>x field
You can't see any such thing.

* * *

>read paper
You must supply a noun.

The Dog runs away

>read paper
You must supply a noun.

* * *

>n
Barn
A large red and white 2 story barn with piles of hay on the ground. There are also two black and white cows roaming around the barn. Hanging on the wall is a milking bucket and next to it also leaning on the wall is a pitchfork. The barns looks if it hasnt been used in years. Back to the south is the field.

You can see Bell, Bells, Milking bucket and Pitchfork here.

* * *

>enter car
You can't see any such thing.

>e
Shed
A medium sized metal shed made of couragated tin sheets. There are many different car parts scattered around the floor. In the corner there are pieces of an old wooden fence as well as some barbed wire. In the other corner is a workbench made of wood with may different things on it.  To the north a car port is attached to the shed behind a locked metal door. back th the east is the field

>n
You can't go that way.