You wake up in a grassy field with no memory of what happened last nignt. You search your pockets and find that you only have a a stick of gum, a rusty razor blade, and a bag of white powder. As you come to you glance at your watch you notice that it is thursday at 800, ONE AND A HALF HOURS BEFORE YOUR BIG JOB INTERVIEW! You begin to panic but then relizing that you are just a 25 minute drive outside of town, and can still make it. Now if you just had a car. . .

What happened last night?
An Interactive Fiction by Dakota Miller
Release 1 / Serial number 140929 / Inform 7 build 6L38 (I6/v6.33 lib 6/12N) SD

Field
A large grassy field with a tractor under a large apple tree under in it. You can just the sun rising over the shed which is to the east.  There is also a dog standing here, he seems excited and keeps running around. To the north is the barn, to the south is is a corn field, and to the west is a forest.

A medium sized sheep dog with a light blue collar around its neck

>N
Barn

>W
You can't go that way.

>S
Field
You can see a metal door and Key here.

* * *

>take key
Taken.

The large furry The Dog leaves.

>drop key
Dropped.

The Dog heads to Garage.

* * *

>take key
Taken.

The large furry The Dog leaves.

>e
Shed

>w
Field
You can see dog (empty) here.

The large furry The Dog leaves.
There is a large furry The Dog here.

* * *

>i
You are carrying:
  rusty razor blade
  stick of gum

The Dog heads to Forest.

>take key
You can't see any such thing.

* * *

>e
Shed

>w
Field

* * *

>n
Barn
You can see dog here.

The Dog leaves

>s
Field
You can see a dog here.

The Dog runs away from you

>w
Forest
You can see a dog here.

The Dog runs away from you

>e
Field

>w
Forest

>e
Field

* * *

>e
Shed

>s
You can't go that way.

The Dog is also hereThe dog is also here

>nn
That's not a verb I recognise.

>w
Field
The dog is also here

>s
Corn Field

>w
You can't go that way.

>e
You can't go that way.

>n
Field
You can see a dog here.

The Dog is also hereThe dog is also here

>x dog
You see nothing special about the dog.

The Dog is also here

* * *

>n
Barn

>n
You can't go that way.

>s
Field

>e
Garage

>w
Field

* * *

>x dog
With dog is empty.

The Dog heads to Corn Field.