You wake up in a grassy field with no memory of what happened last nignt. You search your pockets and find that you only have a a stick of gum, a rusty razor blade, and a bag of white powder. There is also a dog running around the farm that looks vaguely farmiliar. As you come to you glance at your watch you notice that it is thursday at 800, ONE AND A HALF HOURS BEFORE YOUR BIG JOB INTERVIEW! You begin to panic but then relizing that you are just a 25 minute drive outside of town, and can still make it. Now if you just had a car. . .

What happened last night?
An Interactive Fiction by Dakota Miller
Release 1 / Serial number 140930 / Inform 7 build 6L38 (I6/v6.33 lib 6/12N) SD

Field
A large grassy field with a large apple tree in the center of it and a large patch of tall grass next to you. You can just the sun rising over the shed which is to the east.  To the north is the barn, to the south is is a corn field, and to the west is a forest.

>x field
You can't see any such thing.

* * *

>x gum
 A stick of juicy fruit gum

The Dog runs away

* * *

>i
You are carrying:
  rusty razor blade
  stick of gum
  pink speedo
  bag of white powder
  watch

The Dog runs away

>take key
You can't see any such thing.

>w
Forest
You can see dog here.

The Dog heads to Barn.

>take key
You can't see any such thing.

* * *

>i
You are carrying:
  rusty razor blade
  stick of gum
  pink speedo
  bag of white powder
  watch

The Dog runs away

>x self
You are only wearing a sparkly pink speedo

* * *

>x tall grass
You rustle through the tall grass and find a small piece of crumpled paper

The Dog runs away

>take paper
Taken.

>x paper
You see nothing special about Piece of paper.

The dog is here

* * *

>x tall grass
You rustle through the tall grass and find a small piece of crumpled paper

The Dog runs away

>read paper
You see nothing special about Piece of paper.

* * *

>score
There is no score in this story.

* * *

>get into car
you get into the car

* * *

>x self
You are only wearing a sparkly pink speedo

The Dog runs away

* * *

>take key
Taken.

The Dog runs away

* * *

>open metal door
You open metal door.

>n
You can't go that way.

The dog is here

* * *

>please
(There is no need to say please.)
I didn't understand that sentence.

* * *

>e
Shed
A medium sized metal shed made of couragated tin plates. There are many tools scattered around the shed as well as some old wooden fence posts and barbed wire. To the north a car port is attached to the shed behind a locked metal door. back th the east is the field

>w
Field

>n
Barn
You can see dog here.

The Dog leaves

>n
You can't go that way.

>s
Field
The dog is here

>take key
Taken.

The Dog leavesThe dog is here

>e
Shed

>open carport
It seems to be locked.

>unlock carport
What do you want to unlock Carport with?

>key
You unlock Carport.

>open carport
You open Carport.

>enter carport
That's not something you can enter.

* * *

>e
Shed
A medium sized metal shed made of couragated tin plates. There are many tools scattered around the shed as well as some old wooden fence posts and barbed wire. To the north a car port is attached to the shed behind a locked metal door. back th the east is the field

>x player
You can't see any such thing.

>x self
As good-looking as ever.

The dog is here

* * *

>e
Shed
A medium sized metal shed made of couragated tin plates. There are many tools scattered around the shed as well as some old wooden fence posts and barbed wire. To the north a car port is attached to the shed behind a locked metal door. back th the east is the field

>x walls
The metal walls are coated in a thin layer of dust.

The Dog runs awayThe dog is here

* * *

>read paper
You must supply a noun.

The Dog runs away

>take paper
Taken.

>read paper
You see nothing special about Piece of paper.

>x paper
You see nothing special about Piece of paper.

>read piece of paper
You see nothing special about Piece of paper.

>x piece of paper
You see nothing special about Piece of paper.

* * *

>x paper
The paper reads: For a good time call 1-800-6969-911

The Dog runs away

>take paper
That's hardly portable.

* * *

>n
Barn
A large red and white 2 story barn with piles of hay on the ground. There are also two black and white cows roaming around the barn. Hanging on the wall is a milking bucket and next to it also leaning ont he wall is a pitchfork. Back to the south is the field.

>w
You can't go that way.

>s
Field
A large grassy field with a tractor under a large apple tree and a large patch of tall grass next to you. You can just the sun rising over the shed which is to the east.  There is also a dog standing here, he seems excited and keeps running around. To the north is the barn, to the south is is a corn field, and to the west is a forest.

The dog is here

>e
Shed
A white aluminaum garage door that is locked

>n
(first opening metal door)
It seems to be locked.

>s
You can't go that way.

* * *

>e
You can't go that way.

>w
Field
A large grassy field with a tractor under a large apple tree and a large patch of tall grass next to you. You can just the sun rising over the shed which is to the east.  There is also a dog standing here, he seems excited and keeps running around. To the north is the barn, to the south is is a corn field, and to the west is a forest.

>n
Barn
A large red and white 2 story barn with piles of hay on the ground. There are also two black and white cows roaming around the barn. Hanging on the wall is a milking bucket and next to it also leaning ont he wall is a pitchfork. Back to the south is the field.

>s
Field
A large grassy field with a tractor under a large apple tree and a large patch of tall grass next to you. You can just the sun rising over the shed which is to the east.  There is also a dog standing here, he seems excited and keeps running around. To the north is the barn, to the south is is a corn field, and to the west is a forest.

>e
Shed
A white aluminaum garage door that is locked

The Dog leavesThe dog is here

>w
Field
A large grassy field with a tractor under a large apple tree and a large patch of tall grass next to you. You can just the sun rising over the shed which is to the east.  There is also a dog standing here, he seems excited and keeps running around. To the north is the barn, to the south is is a corn field, and to the west is a forest.

The dog is here

>n
Barn
A large red and white 2 story barn with piles of hay on the ground. There are also two black and white cows roaming around the barn. Hanging on the wall is a milking bucket and next to it also leaning ont he wall is a pitchfork. Back to the south is the field.

* * *

>s
Field
A large grassy field with a tractor under a large apple tree and a large patch of tall grass next to you. You can just the sun rising over the shed which is to the east.  There is also a dog standing here, he seems excited and keeps running around. To the north is the barn, to the south is is a corn field, and to the west is a forest.

>e
Shed
A white aluminaum garage door that is locked

>w
Field
A large grassy field with a tractor under a large apple tree and a large patch of tall grass next to you. You can just the sun rising over the shed which is to the east.  There is also a dog standing here, he seems excited and keeps running around. To the north is the barn, to the south is is a corn field, and to the west is a forest.

The Dog leaves

>w
Forest

>take key
You can't see any such thing.

>n
You can't go that way.

>e
Field
A large grassy field with a tractor under a large apple tree and a large patch of tall grass next to you. You can just the sun rising over the shed which is to the east.  There is also a dog standing here, he seems excited and keeps running around. To the north is the barn, to the south is is a corn field, and to the west is a forest.

>take eky
You can't see any such thing.

>take key
You can't see any such thing.

* * *

>start car
That's not a verb I recognise.

* * *

>take eky
You can't see any such thing.

* * *

>e
Shed
A medium sized metal shed made of couragated tin plates. There are many tools scattered around the shed as well as some old wooden fence posts and barbed wire. To the north a car port is attached to the shed behind a locked metal door. back th the east is the field

>unlock door
What do you want to unlock metal door with?

>key
You unlock metal door.

>n
You can't go that way.

>open metal door
You open metal door.